
             NO ./textures/northblue.xpm
                        SO ./textures/southgreen.xpm

WE            ./textures/westred.xpm


 EA ./textures/eastyellow.xpm
                    
C 255,               30         ,    0        
F 220,    100,142  

1111111111111
1000000000001
100000N000001
1000000000001
1111111111111



