             NO ./textures/path_to_the_north_texture
                        SO ./textures/path_to_the_south_texture

WE ./textures/path_to_the_west_texture


 EA ./textures/path_to_the_east_texture
                    
F 220,100,0
C 225,30,0






        11111111111111111111111111
        101 10000000110000000000001
        101100000111000000000000111
        100100000000011100000000011
        10010000000001  10000000001
        10010000000001110000000001
111111111011000001110000000000001
100000000011000001110111111111111
1111011111111101110000010001
11110111111111111101010010001
110000001101   11100000010001
1000000000000N 11100000010001
100000000001   101101010010001
110000011101111111110111100111
11110111 1110101 0 101111110001
11111111 1111111  111111111111
1
1
1
 
1
1
11
1111111111111111111

























