             NO ./textures/path_to_the_north_texture
                        SO ./textures/path_to_the_south_texture

WE ./textures/path_to_the_west_texture


 EA ./textures/path_to_the_east_texture
                    
F 255,202,23
C 88,253,198

1111111111111
1000000000001
1000000000001
1000000000001
1001000100001
100000N000001
1000000000001
1111111111111
