             NO ./textures/path_to_the_north_texture
                        SO ./textures/path_to_the_south_texture

WE ./textures/path_to_the_west_texture


 EA ./textures/path_to_the_east_texture
                    
F 220,100,0
C 225,30,0



11111111111111111111111111111111111111
10000000000000000000000000000000000001
10000000000000000000000000000000000001
10000000000000000000000000000000000001
10000000001000000000000100000000000001
10000000000000000000000000000000000001
10000000000000000000000011100000000001
10000000000100000000000000000000000001
10000000000000000000000000000000000001
10000000000000000N00000000010000000001
10000000000000000000000000000000000001
10000000100000000000000000000000000001
10000000000000000000000000000000000001
11111111111111111111111111111111111111
