             NO ./textures/northblue.xpm
                        SO ./textures/southgreen.xpm

WE            ./textures/westred.xpm


 EA ./textures/eastyellow.xpm
                    
F 220,100,0
C 225,30,0


111111111111111111111111111111111
100000000000000000000000000000001
100000000000000000000000000000001
11111111100000W000001111111011111
100000000000000000000000000000001
100000000000000000000000000000001
111111111111111111111111111111111
